R 640 480

NO ./img_textures/NO.xpm
SO ./img_textures/SO.xpm
WE ./img_textures/WE.xpm
EA ./img_textures/EA.xpm
S ./img_sprites/S.xpm

C 66,135,224
F 125,23,220

        1111111111111111111111111
        1000000111110000000000001
        1011000001110000002000001
        100100000000000E000000001
111111111011000001110000000000001
100000000011000001111111111111111
11110111111111011100000010001
11110111111111010101010010001
11000000110101011100000012001
10002000000000001100000000001
10000000000000001101010010001
1100000111010101111101111000111
11110111 1110101 101111010001
11111111 1111111 111111111111
